NO ./images/north.xpm

SO ./images/south.xpm

WE ./images/west.xpm

EA ./images/east.xpm

F 238,232,170
C 135,206,250

1111111111111111111111111
1010000000000000000000001
1010010011000000000000001
1000010000000001111111111
1000000000000000000000001
100E001111100000000000001
1000000000000000000000001
1111111111111111111111111
