NO ./images/north.xpm

SO ./images/south.xpm

WE ./images/west.xpm

EA ./images/east.xpm

F 220,100,0
C 0,127,255

111111111111111111111111
110000000000000000000001
11000000000000000000000111111
10000000000000000000000000001
1111110000N001110000000111111
11111100000000111100000111111
11111100000000111100000111111
10000000000000111100000111111
1111111111111011110000011111111111        
111111111000011111000000000000001
111111111000000000000000000000001
1111111111111111111111111111111111
