NO ./images/north.xpm

SO ./images/south.xpm

WE ./images/west.xpm

EA ./images/east.xpm

F 238,232,170
C 135,206,250

111111111111111111111111   
100000000000000000000001    
1000000000000000100000011111 
10000000000000000000000000001
111111111111111111111111111111
