











NO ./images/north.xpm















SO	./images/south.xpm











WE	./images/west.xpm











EA	./images/east.xpm





F 238,232,170

C 135,206,250

111111111111111111111111
100000000000000000000001
100000000000000010000001
100000000000000000000001
1111110000N0011100000001
     1000000001111000001
111111000000001 11000001
111111111111111111111111
