NO ./images/north.xpm
SO ./images/south.xpm

WE ./images/west.xpm

EA ./images/east.xpm

F 238,232,170
C 135,206,250

       1111111111111111111111111
1111111100000000000000001
1010010011000000000000001
111111000000011111111111111111
110000000000001000000000001111
111101111100111111N0000111111
1000000000000001 11000001
1000000000000001  10000011
1111101111100111  1100000111111
10000000000000011110000011
1000000000000000000000001
1111111111111111111111111111111111111111111111111












